2 5
OOO%OO%%O%OOO%OO%%X
OOO%OO%%O%OOO%OO%%O
O%OOOOOOO%O%OOOOOOO
O%OO%O%OO%O%OO%O%OO
OO%OOO%%%%OO%OOO%%%
OO%OO%%%%%OO%OO%%%%
OO%OO%%%%%OO%OO%%%%
O%%%OOOOO%O%%%OOOOO
%%%OOOO%%%%%%OOOO%%
%OOO%%OOO%%OOO%%OOO
%OOO%%OOO%%OOO%%OOO
%%%%OOOO%%%%%%OOOO%
OOOOOOOOO%OOOOOOOOO
%%%%O%%%%%%%O%%%%%O
%%OOOOOOO%%%OOO%%%O
OOOOOOOOOOOOOOOOOOO
